             
             
             
             
             
0---    ----1
|           |
|           |
|           |
|           |
|           |
| S     AAA |
|           |
2-----------3
